############
###        #
#aa    AA  #
#aa =  AA  #
#aa    AA  #
###        #
############