############
##        ##
#  a    a  #
#  z  A z  #
#    AAA   #
#   AAA    #
#  a A  a  #
#  z    z  #
##        ##
############  