##################
##              ##
#  z          a  #
#                #
#       AA       #
#       AA       #
#                #
#  a          z  #
##              ##
##################