##########
#    #####
# aa #   #
# aa = A #
#        #
### # ####
### # ####
###    ###
### ######
##########