############
#          #
#    z  #  #
#   wA  #  #
#  zAD     #
#     ADd  #
#     Da   #
#  ## d    #
#          #
############