++++++++++++++++++
#       ++       #
# #   # ++ #   # #
#       ++       #
#   z   AA   a   #
#   a   AA   z   #
#       ++       #
# #   # ++ #   # #
#       ++       #
++++++++++++++++++