############
#####a######
#####=######
####    ####
###   *  ###
### *AA  =a#
#a=  AA* ###
###  *   ###
####    ####
######=#####
######a#####
############