############
#          #
#  =     a #
#      =   #
# z  AA    #
#    AA  z #
#   =      #
# a     =  #
#          #
############