############
###a    a###
###  //  ###
#a   //   a#
#          #
#     A    #
#a  AAA   a#
###  AAA ###
###a A  a###
############