++++++++++++
#          #
#          #
#  aa      #
#    AA >  #
#     AA   #
#  aa      #
#          #
#          #
++++++++++++