#############
#######=#####
#= cbcc #####
##c####c#####
##a####c#####
##c####c    #
##c####a##AA#
## ccbc =#BB#
##=##########
#############