##################
#    ##    ##    #
# ab ##       BA #
# cd ##    ## CD #
#          ##    #
####       #### ##
####       #### ##
####             #
####             #
##################