#########
#   #   #
# d #   #
# d   a #
#     d #
#     d #
# a   b #
# b #   #
#   #   #
#########