################
#    ##  ##    #
# ab ##     BA #
# cd ##  ## CD #
#        ##    #
####     #### ##
####     #### ##
####           #
################