############
#    ##    #
# dd ##    #
# dd    ab #
#       dd #
#       dd #
# ab    cd #
# cd ##    #
#    ##    #
############