##################
#                #
#  # aa       #  #
#    a           #
#       AA       #
#      AAAA      #
#           a    #
#  #       aa #  #
#                #
##################