#####++#####
###  ++  ###
###  ++  ###
#aa  **  ###
#aa  **  AA#
#aa  **  AA#
#aa  **  ###
###  ++  ###
###  ++  ###
#####++#####