###########
#         #
## aa    ##
#  aAA    #
#  AAAAa  #
##    aa ##
#         #
###########