###########
#      aa #
#  #   aa #
#    AA   #
#     AA  #
###########