###########
#  ab ##  #
#  cd     #
#CD       #
#AB   ##  #
###########