#####
#ab #
#   #
# AC#
#####