########
#      #
#  aa  #
#  aa A#
#++  AA#
#++   A#
#  aaAA#
#  aa  #
#      #
########