+++++######
+++       #
+++  aaaa #
+      A  #
+     AA  #
#    AAA  #
#         #
#  aaaa ###
#       ###
###########