#########
#   #   #
# d #   #
# d   A #
#     D #
#     D #
# a   B #
# b #   #
#   #   #
#########