################
#    ##  ##    #
# ab ##     BA #
# cd ##  ## CD #
#        ##    #
####     #######
################
