##################
#                #
#       aa       #
#       aa    A  #
#  ++        AA  #
#  ++         A  #
#       aa   AA  #
#       aa       #
#                #
##################