############
#    ##    #
# dd ##    #
# dd    AB #
#       DD #
#       DD #
# ab    CD #
# cd ##    #
#    ##    #
############
