##########
#        #
#        #
#  aaAA  #
#  a##A  #
#  a##A  #
#  aaAA  #
#        #
#        #
##########