##############
#            #
#            #
#  aaa   A   #
#  a*a  AAA  #
#  aaa   A   #
#            #
#            #
##############