##################
#  ###           #
#                #
#           ##   #
#            #   #
#    ee   ab   E #
#    ee   cd  AE #
#              E #
#    ++          #
##         ###   #
##################
